11111111
10000CE1
10C0CP01
11111111
