1111111111111
100000C000CE1
100C00000C001
1PC00000C0001
1111111111111
