11111111
1PC00011
100000C1
100C1C11
10000EC1
11111111