11111111
1PC01111
10001111
100C1111
10000E01
11111111
