11111111
1PC01111
10001111
100C1111
10000EC1
11111111
