01111111
10EC1C01
1000P001
11111111